wwwwwwwwwwwww
wA.......w..w
w..w........w
w...w...w.+ww
www.w3..wwwww
w.......w.g.w
w.3.........w
w.....3.....w
wwwwwwwwwwwww
