wwwwwwwwwwwww
wA......§w..w
w..w........w
w...w...w.+ww
www.w¦..wwwww
w.......w.g.w
w.w.........w
w.....§.....w
wwwwwwwwwwwww
